         11111111111             
         10000000001
         10000000001
111111111100000000011111111111111111111
100000000000000000000000001000000000001
100000000000000000000000001000000000001
100000000000000000000000001000000000001
100000000000100000000000001000000000001
100000000000100000000000000000000000001
100000000000100000000000000000000000001
100000000000000000000000000111111111111
100000000000000000000000000000000000001
100000000000000000000000000000000000001
100000000000000000100000000000000000001
100000000000000000100000000000000000001
100000000000000000111111100000000000001
100000000000000000000000000000000000001
100000000000000000000000000000000000001
111111111111111111111111000000000000001
                       1000000000000001
                       1000000000000001
                       1000000000000001
                       1000000000000001
                       1000000000000001
                       1000000000000001
                       1111111111111111